e=east
w=west
n=north
s=south
ne=northeast
nw=northwest
se=southeast
sw=southwest
go=move
take=get
"let's boogie"=move
drop=release
put=release
make=create
do=perform
say=speak
see=look
hear=listen
know=understand
think=ponder
want=desire
have=possess
be=exist
come=arrive
give=offer
find=discover
learn=study
eat=consume
drink=imbibe
sleep=rest
run=sprint
jump=leap
walk=stroll
talk=chat
listen=hear
read=peruse
write=compose
create=build
imagine=envision
dream=aspire
wish=desire
hope=aspire
expect=anticipate
believe=trust
love=adore
hate=abhor
fear=dread
enjoy=delight
laugh=chuckle
cry=weep
smile=grin
frown=scowl
shout=yell
whisper=murmur
sing=croon
dance=sway
play=amuse
work=labor
rest=relax
travel=journey
explore=discover
search=seek
lose=misplace
keep=hold
give=offer
share=divide
bring=fetch
send=dispatch
receive=get
buy=purchase
sell=offer
trade=exchange
borrow=loan
lend=advance
pay=compensate
owe=debt
own=possess
use=utilize
need=require
like=enjoy
dislike=disapprove
care=concern
help=assist
support=aid
protect=safeguard
serve=attend
follow=pursue
lead=guide
manage=direct
organize=arrange
plan=scheme
prepare=ready
prevent=avert
promote=advance
propose=suggest
provide=supply
publish=issue
pursue=follow
reach=attain
realize=understand